R 500 500

C	./text2/bluestone.xpm
F	 255,0,0

S ./text2/pillar.xpm
T ./text2/barrel.xpm

SO ./text2/bluestone.xpm
NO ./text2/greystone.xpm
WE ./text2/purplestone.xpm
EA ./text2/redbrick.xpm

1111111111111111111111111111111
1000000000020000000300000000011
1000000000000000000300000000001
1000000000000000000000000000001
1000000000000000N00000000000001
1000000000000000000000000000001
1111111111111111111111111111111
