R 1 1
C	./text2/bluestone.xpm
F	 255,   0,    0

S ./text2/pillar.xpm
T ./text2/barrel.xpm

SO ./text2/bluestone.xpm
NO ./text2/greystone.xpm
WE ./text2/purplestone.xpm
EA ./text2/redbrick.xpm

1
1
1
1
1
1
1111111111111101111111111111111
1000200000000000000000000000001
1000000000002000000000000000001
1000000000002000000000000000001
1000000000002000000000000000001
1000000001E00000300020000000001
1111111111111111111111111111111